NO ./textures/wickedsnow03-64x64.png
SO ./textures/wickedsnow05-64x64.png
WE ./textures/wickedrock1a-64x64.png
EA ./textures/wickedrock1-64x64.png   
F 64, 64, 64 
C 112,163,204
111111111111111111111111111111111111111111111111111111111
100000000000000000000000000000000000000000000000000000001
100000000000100000000000000000000000000000000000000000001
10E000000000010000000000000000000000000000000000000000001
100000000000001000000000000000000000000000000000000000001
100000000000000000000000000000000000000000000000000000001
100000000000000000000000000000000000000000000000000000001
100000000000000000000000000000000000000000000000000000001
100000000000000000000000000000000000000000000000000000001
111111111111111111111111111111111111111111111111111111111
